w,w,w,w,w,x,S,w,x,w,
w,x,w,w,x,w,w,w,w,w,
w,w,w,x,w,w,w,x,w,w,
x,w,w,w,w,x,w,w,w,w,
w,w,x,w,w,w,w,x,w,w,
w,w,w,w,x,w,w,w,w,x,
w,x,w,w,w,w,x,w,w,w,
w,w,w,x,w,w,w,w,x,w,
x,w,x,w,w,w,w,w,w,w,
w,w,w,w,x,w,w,w,x,w,
